+--+--+--+--+--+--+--+--+--+--+
                  |        |  |
+--+--+  +--+--+  +  +--+  +  +
|     |  |  |     |  |     |  |
+  +  +  +  +  +--+--+  +--+  +   
|  |  |  |  |        |     |
+  +--+  +  +--+--+  +  +  +  +
|           |     |     |     |
+--+--+  +--+  +  +--+--+--+  +
|     |     |  |  |        |  |
+  +  +  +  +  +  +  +--+  +  +
|  |     |  |  |     |     |  |
+  +--+--+  +  +--+--+  +--+  +
|        |     |  |     |     |
+--+--+  +--+--+  +  +--+--+--+
|           |  |     |        |
+  +--+--+  +  +--+--+  +--+  +
|        |     |     |  |     |
+--+--+  +  +--+  +  +  +  +--+
|        |        |     |      
+--+--+--+--+--+--+--+--+--+--+